22222220011111022222
22222220110000022222
22222220100222222222
00000000102200000002
01111111102201111102
01000000002201000102
01022222222201020102
01000022222201020102
01111020000001020102
00001020111111020102
22201020100000020102
22201020A02222220102
00001020002200000102
01111022222201111102
00000022000001000002